aguascalientes : Aguascalientes
baja_california : Baja California
baja_california sur : Baja California Sur
campeche : Campeche
chiapas : Chiapas
chihuahua : Chihuahua
ciudad_de_mexico : Ciudad de México
coahuila : Coahuila
colima : Colima
durango : Durango
estado_de_mexico : Estado de México
guanajuato : Guanajuato
guerrero : Guerrero
hidalgo : Hidalgo
jalisco : Jalisco
michoacan : Michoacán
morelos : Morelos
nayarit : Nayarit
nuevo_leon : Nuevo León
oaxaca : Oaxaca
puebla : Puebla
queretaro : Querétaro
quintana_roo : Quintana Roo
san_luis_potosi : San Luis Potosí
sinaloa : Sinaloa
sonora : Sonora
tabasco : Tabasco
tamaulipas : Tamaulipas
tlaxcala : Tlaxcala
veracruz : Veracruz
yucatan : Yucatán
zacatecas : Zacatecas